##########################################
# it-italy  [it]


Roma         =>  AS Roma,  Roma
Lazio        =>  SS Lazio, Roma

Milan        =>  AC Milan,                 Milano
Inter        =>  FC Internazionale Milano, Milano

Torino       =>  Torino FC,   Torino
Juventus     =>  Juventus,    Torino

Verona       => Hellas Verona FC, Verona
Chievo       => AC Chievo Verona, Verona

Genoa        =>  Genoa CFC,      Genova
Sampdoria    =>  UC Sampdoria,   Genova

Atalanta     => Atalanta BC,     Bergamo
Benevento    => Benevento,       Benevento
Bologna      => Bologna FC,      Bologna
Cagliari     => Cagliari Calcio, Cagliari
Crotone      => FC Crotone,      Crotone
Fiorentina   =>  ACF Fiorentina, Firenze
Napoli       =>  SSC Napoli,     Napoli
Sassuolo     =>  US Sassuolo Calcio, Sassuolo
Spal         =>  SPAL,           Ferrara
Udinese      =>  Udinese Calcio, Udine


Ascoli       =>  Ascoli, Ascoli Piceno
Avellino     =>  Avellino, Avellino
Bari         =>  Bari, Bari
Brescia      =>  Brescia, Brescia
Carpi        =>  Carpi, Carpi
Cesena        => Cesena, Cesena
Cittadella   => Cittadella, Cittadella
Cremonese     => Cremonese, Cremona
Empoli        => Empoli, Empoli
Foggia        => Foggia, Foggia
Frosinone     => Frosinone, Frosinone
Novara        => Novara, Novara
Palermo       => Palermo, Palermo
Parma         => Parma, Parma
Perugia       => Perugia, Perugia
Pescara       => Pescara, Pescara
Pro Vercelli  =>  Pro Vercelli, Vercelli
Salernitana   => Salernitana, Salerno
Spezia        => Spezia, La Spezia
Ternana       => Ternana, Terni
Venezia       => Venezia, Venezia
Virtus Entella   =>   Virtus Entella, Chiavari


Piacenza    => Piacenza Calcio 1919, Piacenza
Vicenza     => LR Vicenza Virtus, Vicenza
Padova	    =>	Calcio Padova, Padova
Modena      => Modena FC, Modena
Siena       => SS Robur Siena, Siena
Ancona      =>  US Anconitana ASD, Ancona

Cosenza     => Cosenza Calcio, Cosenza
F. Andria   => SS Fidelis Andria 1928, Andria   ## Fidelis Andria
Lecce       => US Lecce, Lecce
Lucchese    => AS Lucchese Libertas 1905,	Lucca
Monza       => SS Monza 1912, Monza
Ravenna     => Ravenna FC 1913, Ravenna
Reggiana    => AC Reggiana 1919, Reggio Emilia
Reggina     => Urbs Reggina 1914, Reggio Calabria
Treviso     => ACD Treviso, Treviso
C. Sangro   =>  ASD Castel di Sangro, Castel di Sangro
Albinoleffe => Unione Calcio Albinoleffe, Albino e Leffe
Catania     => Calcio Catania, Catania
Como        => Como 1907, Como
Livorno     => AS Livorno Calcio, Livorno
Messina     => ACR Messina SSD, Messina
Triestina   => US Triestina Calcio 1918, Trieste
Arezzo      => SS Arezzo, Arezzo
Catanzaro   => US Catanzaro 1929, Catanzaro
