#############################################
## pt-portugal


Benfica        => SL Benfica,       Lisboa
Sp Lisbon      => Sporting CP,      Lisboa     ## Sporting Clube de Portugal
Belenenses     => Os Belenenses,    Lisboa

Porto          => FC Porto,     Porto
Boavista       => Boavista FC,  Porto


Aves         => CD Aves, Aves
Chaves       => GD Chaves, Chaves
Estoril      => Estoril Praia, Estoril
Feirense     => CD Feirense, Santa Maria da Feira
Guimaraes    => Vitória de Guimarães, Guimarães   ## Vitória SC
Maritimo     => CS Marítimo, Funchal
Moreirense    => Moreirense FC, Moreira de Cónegos
Pacos Ferreira  => FC Paços de Ferreira, Paços de Ferreira
Portimonense    => Portimonense SC, Portimão
Rio Ave        => Rio Ave FC, Vila do Conde
Setubal        => Vitória de Setúbal, Setúbal   ## Vitória FC
Sp Braga       => SC Braga, Braga
Tondela        => CD Tondela, Tondela

Academica     =>  Académica de Coimbra, Coimbra  ## Associação Académica de Coimbra – Organismo Autónomo de Futebol (AAC–OAF)
Arouca        =>  FC Arouca, Arouca
Nacional      =>  CD Nacional Madeira, Funchal   ## Clube Desportivo Nacional
Penafiel      =>  FC Penafiel, Penafiel

Beira Mar        => SC Beira-Mar, Aveiro
Desp. Chaves     => Desportivo de Chaves, Chaves
Est Amadora      => CF Estrela da Amadora, Amadora
Farense          => SC Farense, Faro
Gil Vicente      => Gil Vicente FC, Barcelos
Leiria                   => União de Leiria,   Leiria    ## União Desportiva de Leiria
Madeira | Uniao Madeira  => União da Madeira,  Funchal
Salgueiros       => SC Salgueiros,  Paranhos
Tirsense         => FC Tirsense,  Santo Tirso
Campomaior | Campomaiorense   => SC Campomaiorense, Campo Maior
Felgueiras       => FC Felgueiras, Felgueiras
Leca             => Leça FC, Leça da Palmeira


Alverca                => FC Alverca, Alverca do Ribatejo
Espinho                => Sporting de Espinho,  Espinho     ## Sporting Clube de Espinho
Leixoes                => Leixões SC, Matosinhos
Naval                  => Naval 1º de Maio, Figueira da Foz  ## Associação Naval 1º de Maio
Olhanense              => SC Olhanense,     Olhão
Santa Clara            => CD Santa Clara,   Ponta Delgada
Trofense               => CD Trofense,     Tulipa  ## Clube Desportivo Trofense
Varzim                 => Varzim SC,       Póvoa de Varzim
