#############################################
## fr-france (and mc-monaco)


Monaco      => AS Monaco, Monaco


Paris SG    => Paris Saint-Germain, Paris
Paris FC    => Paris FC, Paris


Amiens      => Amiens SC, ?
Angers      => Angers SCO, ?
Bordeaux    => Girondins de Bordeaux, Bordeaux

Caen        => Stade Malherbe Caen, ?    ## use - SM Caean - why? why not?
Dijon       => Dijon FCO, Dijon
Guingamp    => EA Guingamp, ?
Lille       => Lille OSC, Lille
Lyon        => Olympique Lyonnais, Lyon
Marseille   => Olympique de Marseille, Marseille
Metz        => FC Metz, Metz

Montpellier => Montpellier HSC, Montpellier   ## use - Montpellier Hérault SC - why? why not?
Nantes      => FC Nantes, Nantes
Nice        => OGC Nice, Nice


Rennes      => Stade Rennais FC, Rennes
St Etienne  => AS Saint-Étienne, ?
Strasbourg  => RC Strasbourg, Strasbourg
Toulouse    => Toulouse FC, Toulouse
Troyes      => ES Troyes AC, ?
Reims       => Stade de Reims, Reims
Nimes       => Nîmes Olympique, Nîmes

Ajaccio         => AC Ajaccio,  Ajaccio
Ajaccio GFCO    => GFC Ajaccio, Ajaccio

Auxerre         => AJ Auxerre, ?
Bourg Peronnas  => Bourg-en-Bresse 01, ?    ## use - Bourg-en-Bresse - why? why not?
Brest           => Stade Brestois 29, Brest
Chateauroux     => LB Châteauroux, ?
Clermont        => Clermont Foot 63, Clermont
Le Havre        => Le Havre AC, Le Havre
Lens            => RC Lens, ?
Lorient         => FC Lorient, ?
Nancy           => AS Nancy Lorraine, Nancy
Niort           => Chamois Niortais FC, ?
Orleans         => US Orléans, Orléans

Quevilly Rouen  => US Quevilly-Rouen Métropole,  ?   ## use Quevilly-Rouen - why? why not?
Sochaux         => FC Sochaux-Montbéliard, ?
Tours           => Tours FC, Tours
Valenciennes    => Valenciennes FC, ?

Arles            => AC Arles-Avignon, ?

Bastia           => SC Bastia, Bastia
CA Bastia        => CA Bastia, Bastia

Beauvais         => AS Beauvais Oise, ?

Besancon         => Racing Besançon, ?   ## use Besançon RC - why? why not?
Boulogne         => US Boulogne, ?
Cannes           => AS Cannes, Cannes
Charleville      => FCO Charleville,
Creteil          => US Créteil,
Epinal           => SAS Épinal,
Evian Thonon Gaillard  => Évian TG FC,    ## use Évian Thonon-Gaillard FC - why? why not?
Grenoble         => Grenoble Foot 38, Grenoble
Gueugnon       => FC Gueugnon, ?
Istres         => FC Istres, ?
Laval          => Stade Lavallois, ?
Le Mans        => Le Mans FC, Le Mans
Libourne       => FC Libourne-Saint-Seurin,
Louhans-Cuis.  => CS Louhans-Cuiseaux,
Martigues      => FC Martigues,
Mulhouse       => FC Mulhouse, Mulhouse
Perpignan      => Perpignan FC,

##
# Red Star History
# - Red Star FC 93 (2003-2012)
# - Red Star FC (2012-)
Red Star, Red Star 93  => Red Star FC,

Rouen          => FC Rouen,
Sedan          => CS Sedan-Ardennes,
Sete           => FC Sète,
St Brieuc      => Stade Briochin,
Toulon         => Sporting Toulon Var,

Valence        => ASOA Valence, Valence   ## use Olympique Valence - why? why not?
Vannes         => Vannes OC,
Wasquehal      => Wasquehal Foot,         ## use ES Wasquehal - why? why not?
