##########################################
# nl-netherlands


Ajax                      => Ajax Amsterdam, Amsterdam

Feyenoord                 => Feyenoord Rotterdam,     Rotterdam
Sparta, Sparta Rotterdam  => Sparta Rotterdam,        Rotterdam
Excelsior                 => SBV Excelsior Rotterdam, Rotterdam    ## use SBV Excelsior - why? why not?


AZ Alkmaar      => AZ Alkmaar, Alkmaar
Cambuur         => SC Cambuur, Leeuwarden
Den Bosch       => FC Den Bosch, 's-Hertogenbosch
Den Haag        => ADO Den Haag, Den Haag
Dordrecht       => FC Dordrecht, Dordrecht
For Sittard     => Fortuna Sittard, Sittard
Go Ahead Eagles => Go Ahead Eagles, Deventer
Graafschap      => BV De Graafschap,  Doetinchem
Groningen       => FC Groningen, Groningen
Heerenveen      => SC Heerenveen, Heerenveen
Heracles        => Heracles Almelo, Almelo
MVV Maastricht  => MVV Maastricht, Maastricht
NAC Breda       => NAC Breda, Breda
Nijmegen        => NEC Nijmegen, Nijmegen
PSV Eindhoven   => PSV Eindhoven, Eindhoven

Roda, Roda JC   => Roda JC Kerkrade,  Kerkrade

Roosendaal       => RBC Roosendaal, Roosendaal


Twente           => FC Twente,  Enschede
Utrecht          => FC Utrecht, Utrecht
VVV Venlo        => VVV Venlo, Venlo      ## use VVV-Venlo - why? why not?
Vitesse          => Vitesse Arnhem, Arnhem
Volendam         => FC Volendam, Volendam
Waalwijk         => RKC Waalwijk, Waalwijk


Willem II        => Willem II Tilburg, Tilburg    ## use Willem II - why? why not?
Zwolle           => PEC Zwolle, Zwolle
