##########################################
# be-belgium   - [nl,fr,de]


Anderlecht     => RSC Anderlecht, Brussels
FC Brussels    => FC Brussels,    Brussels


Antwerp      => Royal Antwerp FC,    Antwerpen
Charleroi    => Sporting Charleroi, Charleroi   ##  [fr]	Royal Charleroi Sporting Club; Sporting de Charleroi
Eupen        => KAS Eupen,   Eupen  ## [de]
Genk         => KRC Genk,   Genk
Gent         => KAA Gent,       Gent
Kortrijk     => KV Kortrijk,    Kortrijk
Lokeren      => KSC Lokeren OV,  Lokeren   ##  Sporting Lokeren
Mechelen     => KV Mechelen,     Mechelen

Club Brugge         => Club Brugge,    Brugge     ## Club Brugge KV
Cercle Brugge       => Cercle Brugge,  Brugge     ## Cercle Brugge KSV

Mouscron, Mouscron-Peruwelz    => Royal Excel Moeskroen, Moeskroen

Oostende     => KV Oostende,        Oostende
St Truiden   => Sint-Truidense VV,  Sint-Truiden
Standard          => Standard Liège,   Liège   ## [fr] Standard de Liège
Waasland-Beveren  => Waasland-Beveren,  Beveren   ## KVRS Waasland - SK Beveren
Waregem      => SV Zulte Waregem,  Waregem


Westerlo    => KVC Westerlo,
Lierse       => K Lierse SK,
Aalst     => SC Eendracht Aalst,
Bergen    => RAEC Mons,
Beveren   => KSK Beveren,
Dender    => FCV Dender EH,
Geel           => KFC Verbroedering Geel,
Germinal       => Germinal Beerschot,
Harelbeke      => KRC Harelbeke,
Heusden Zolder => K Heusden-Zolder,
Lommel         => KFC Lommel SK,
Louvieroise    => RAA Louviéroise,
Molenbeek      => RWD Molenbeek,
Roeselare      => KSV Roeselare,
Seraing        => RFC Seraing,
Tubize         => AFC Tubize,
Oud-Heverlee Leuven => Oud-Heverlee Leuven,
