##########################################
# be-belgium   - [nl,fr,de]


Anderlecht     => RSC Anderlecht, Brussels
FC Brussels    => FC Brussels,    Brussels
Molenbeek      => RWD Molenbeek,  Brussels


Antwerp        => Royal Antwerp FC,    Antwerpen › Antwerpen › Vlaanderen
Germinal       => Germinal Beerschot,  Antwerpen › Antwerpen › Vlaanderen



Charleroi                     => Sporting Charleroi,    Charleroi › Hainaut › Wallonie  ##  [fr]	Royal Charleroi Sporting Club; Sporting de Charleroi
Mouscron | Mouscron-Peruwelz  => Royal Excel Mouscron,  Mouscron  › Hainaut › Wallonie     ## Moeskroen [nl]
Bergen                        => RAEC Mons,             Mons      › Hainaut › Wallonie     ##  Bergen [nl]

Eupen                         => KAS Eupen,             Eupen     › Liège   › Wallonie    ## [de]
Standard | Standard Liege     => Standard Liège,        Liège     › Liège   › Wallonie    ## [fr] Standard de Liège


Mechelen     => KV Mechelen,    Mechelen › Antwerpen › Vlaanderen
Westerlo     => KVC Westerlo,   Westerlo › Antwerpen › Vlaanderen
Lierse       => K Lierse SK,    Lier     › Antwerpen › Vlaanderen

Genk         => KRC Genk,           Genk         › Limburg › Vlaanderen
St Truiden   => Sint-Truidense VV,  Sint-Truiden › Limburg › Vlaanderen

Gent         => KAA Gent,            Gent        › Oost-Vlaanderen › Vlaanderen
Lokeren      => KSC Lokeren OV,      Lokeren     › Oost-Vlaanderen › Vlaanderen  ##  Sporting Lokeren
Aalst        => SC Eendracht Aalst,  Aalst       › Oost-Vlaanderen › Vlaanderen
Dender       => FCV Dender EH,       Denderleeuw › Oost-Vlaanderen › Vlaanderen

Waasland-Beveren  => Waasland-Beveren,  Beveren › Oost-Vlaanderen › Vlaanderen   ## KVRS Waasland - SK Beveren
Beveren           => KSK Beveren,       Beveren › Oost-Vlaanderen › Vlaanderen



Club Brugge         => Club Brugge,    Brugge › West-Vlaanderen › Vlaanderen     ## Club Brugge KV
Cercle Brugge       => Cercle Brugge,  Brugge › West-Vlaanderen › Vlaanderen     ## Cercle Brugge KSV

Kortrijk            => KV Kortrijk,       Kortrijk › West-Vlaanderen › Vlaanderen
Oostende            => KV Oostende,       Oostende › West-Vlaanderen › Vlaanderen
Waregem             => SV Zulte Waregem,  Waregem  › West-Vlaanderen › Vlaanderen




Geel           => KFC Verbroedering Geel, Geel
Harelbeke      => KRC Harelbeke, Harelbeke
Heusden Zolder => K Heusden-Zolder,  Heusden-Zolder
Lommel         => KFC Lommel SK,  Lommel
Louvieroise    => RAA Louviéroise, La Louvière
Roeselare      => KSV Roeselare, Roeselare
Seraing        => RFC Seraing, Seraing
Tubize         => AFC Tubize, Tubize
Oud-Heverlee Leuven => Oud-Heverlee Leuven,  Leuven
