##############################
### de-deutschland

Bayern Munich | Bayern Muenchen           =>  Bayern München,   München › Bayern
Munich 1860 | TSV 1860 Muenchen           =>  TSV 1860 München, München › Bayern


Nurnberg | 1. FC Nuernberg                =>  1. FC Nürnberg, Nürnberg › Bayern    ### todo: always map Nurnberg to 1. FC Nürnberg ?!
Greuther Furth | SpVgg Greuther Fuerth    => Greuther Fürth, Fürth    › Bayern
Augsburg                                  => FC Augsburg,    Augsburg › Bayern
Unterhaching                             =>  SpVgg Unterhaching,  Unterhaching › Bayern
Ingolstadt                               =>  FC Ingolstadt 04,    Ingolstadt › Bayern               ##  bis 2004 MTV Ingolstadt und ESV Ingolstadt-Ringsee
Regensburg                               =>   SSV Jahn Regensburg,   Regensburg › Bayern
Schweinfurt                              =>   1. FC Schweinfurt 05,  Schweinfurt › Bayern
Wurzburger Kickers                       =>   Würzburger Kickers,     Würzburg › Bayern
Burghausen                               =>  Wacker Burghausen,  Burghausen › Bayern


FC Koln | 1. FC Koeln           => 1. FC Köln,   Köln › Nordrhein-Westfalen
F Koln  | Fortuna Koeln         => Fortuna Köln, Köln › Nordrhein-Westfalen

Dusseldorf | Fortuna Dusseldorf | Fortuna Duesseldorf   => Fortuna Düsseldorf, Düsseldorf › Nordrhein-Westfalen


Dortmund           =>  Borussia Dortmund,    Dortmund      › Nordrhein-Westfalen
Schalke 04         =>  FC Schalke 04,        Gelsenkirchen › Nordrhein-Westfalen
Leverkusen | Bayer Leverkusen =>  Bayer 04 Leverkusen,  Leverkusen    › Nordrhein-Westfalen
Duisburg                      =>  MSV Duisburg,         Duisburg      › Nordrhein-Westfalen     ## until 1965/66 Meidericher SV
Bor. Moenchengladbach | M'Gladbach | M'gladbach | Borussia Monchengladbach  => Bor. Mönchengladbach, Mönchengladbach › Nordrhein-Westfalen

Bochum             =>  VfL Bochum,            Bochum › Nordrhein-Westfalen
Wattenscheid       =>  SG Wattenscheid 09,    Bochum › Nordrhein-Westfalen   ## Bochum-Wattenscheid - Bochumer Stadtbezirk

Bielefeld          =>  Arminia Bielefeld,    Bielefeld     › Nordrhein-Westfalen
Preussen Muenster  =>  Preussen Münster,     Münster       › Nordrhein-Westfalen
Gutersloh          =>  Gütersloh,            Gütersloh     › Nordrhein-Westfalen
Uerdingen | Bayer 05 Uerdingen   =>  KFC Uerdingen,        Krefeld       › Nordrhein-Westfalen     ## bis 1995 FC Bayer 05 Uerdingen
Aachen             =>  Alemannia Aachen,     Aachen        › Nordrhein-Westfalen
Paderborn          =>  SC Paderborn 07,      Paderborn     › Nordrhein-Westfalen
Ahlen                  =>  Rot Weiss Ahlen,    Ahlen › Nordrhein-Westfalen
Oberhausen | Rot-Weiss Oberhausen  =>   Rot-Weiß Oberhausen,   Oberhausen › Nordrhein-Westfalen
Siegen                 =>   Sportfreunde Siegen,   Siegen › Nordrhein-Westfalen
Wuppertaler            =>   Wuppertaler SV,         Wuppertal › Nordrhein-Westfalen
Essen | RW Essen       =>  Rot-Weiss Essen,     Essen › Nordrhein-Westfalen
##  - 2 (1): 1993-94
##  - 2 (3): 2006-07 2004-05 1996-97

## note:  Schwarz-Weiß Essen  (played in 2. liga too)



Saarbrucken | 1. FC Saarbruecken     =>  1. FC Saarbrücken,   Saarbrücken › Saarland
Homburg                              =>  FC 08 Homburg,       Homburg     › Saarland
Borussia Neunkirchen                 => Borussia Neunkirchen,  Neunkirchen › Saarland

Osnabruck     =>  Osnabrück,               Osnabrück › Niedersachsen
Wolfsburg     =>  VfL Wolfsburg,           Wolfsburg › Niedersachsen
Hannover      =>  Hannover 96,             Hannover › Niedersachsen
Braunschweig  =>  Eintracht Braunschweig,  Braunschweig › Niedersachsen
Meppen        =>   SV Meppen,              Meppen › Niedersachsen
Oldenburg      =>   VfB Oldenburg,         Oldenburg › Niedersachsen


Cottbus        =>  Energie Cottbus,      Cottbus › Brandenburg
Babelsberg     =>  SV Babelsberg 03,     Potsdam › Brandenburg     ## (Potsdam-Babelsberg)


Hertha                   =>   Hertha BSC,            	Berlin › Berlin
TB Berlin | TeBe Berlin  =>   Tennis Borussia Berlin, Berlin › Berlin
Union Berlin             =>   1. FC Union Berlin,     Berlin › Berlin
Blau-Weiss 90 Berlin     =>   Blau-Weiß 90 Berlin (-1992), Berlin › Berlin
Tasmania 1900 Berlin     =>   SC Tasmania 1900 Berlin (-1973), Berlin › Berlin

BFC Dynamo   => BFC Dynamo Berlin,     Berlin › Berlin


Hamburg               =>  Hamburger SV,      Hamburg › Hamburg
St Pauli | St. Pauli  =>  FC St. Pauli,      Hamburg › Hamburg   ## use stadtteil St. Pauli ??

Werder Bremen =>  Werder Bremen,      Bremen › Bremen


Stuttgart       =>  VfB Stuttgart,         Stuttgart › Baden-Württemberg
Stuttgarter K  =>   Stuttgarter Kickers,   Stuttgart › Baden-Württemberg
Freiburg      =>  SC Freiburg,       	  Freiburg  › Baden-Württemberg
Hoffenheim | 1899 Hoffenheim  =>  TSG 1899 Hoffenheim,  Sinsheim › Baden-Württemberg   ## Sinsheim-Hoffenheim
Karlsruhe     =>  Karlsruher SC,        Karlsruhe › Baden-Württemberg
Ulm           =>  SSV Ulm 1846,         Ulm › Baden-Württemberg
Aalen                  =>  VfR Aalen,          Aalen › Baden-Württemberg
Heidenheim             =>   1. FC Heidenheim,   Heidenheim an der Brenz › Baden-Württemberg
Reutlingen             =>   SSV Reutlingen 05,     Reutlingen › Baden-Württemberg
Sandhausen             =>   SV Sandhausen,         Sandhausen › Baden-Württemberg
Mannheim               =>   VfR Mannheim,        Mannheim › Baden-Württemberg
  ##  - 2 (8): 2002-03....1999-00 (4) 1996-97....1993-94 (4)
Waldhof Mannheim       =>   SV Waldhof Mannheim,   Mannheim › Baden-Württemberg
  ## note: SV Waldhof Mannheim (played in 1. liga and 2. liga too)



Ein Frankfurt                  =>  Eintracht Frankfurt, Frankfurt am Main › Hessen
FSV Frankfurt | Frankfurt FSV  =>  FSV Frankfurt,       Frankfurt am Main › Hessen

Darmstadt      =>  SV Darmstadt 98,       Darmstadt › Hessen
Wehen          =>   SV Wehen Wiesbaden,     Wiesbaden › Hessen
Offenbach      =>   Kickers Offenbach,     Offenbach am Main › Hessen


Kaiserslautern =>  1. FC Kaiserslautern, Kaiserslautern › Rheinland-Pfalz
Mainz          =>  1. FSV Mainz 05,      Mainz          › Rheinland-Pfalz
Ein Trier      =>  Eintracht Trier,      Trier          › Rheinland-Pfalz
Koblenz        =>   TuS Koblenz,         Koblenz        › Rheinland-Pfalz

Lubeck         =>  Lübeck,               Lübeck  › Schleswig-Holstein
Holstein Kiel  =>   Holstein Kiel,       Kiel    › Schleswig-Holstein

Hansa Rostock  =>  Hansa Rostock,        Rostock › Mecklenburg-Vorpommern


Dresden        =>  Dynamo Dresden,      Dresden › Sachsen

RB Leipzig             =>  RB Leipzig,           Leipzig › Sachsen
Leipzig | VfB Leipzig  =>  VfB Leipzig (-2004),  Leipzig › Sachsen   ## note: 2004 augelöst in bl 1993/94

Chemnitz               =>  Chemnitzer FC,       Chemnitz › Sachsen
Erzgebirge Aue         =>  FC Erzgebirge Aue,   Aue      › Sachsen
Zwickau                =>   FSV Zwickau,        Zwickau  › Sachsen

CZ Jena                =>  FC Carl Zeiss Jena,  Jena   › Thüringen
Erfurt                 =>  FC Rot-Weiß Erfurt,  Erfurt › Thüringen
