##################################
# eng-england
#
#  note: see wal.txt for teams from wales


Arsenal    =>  Arsenal FC, London   ## Greater London
Chelsea    =>  Chelsea FC, London   ## Greater London
Tottenham | Tottenham Hotspur =>  Tottenham Hotspur FC, London   ## Greater London
West Ham  | West Ham United   =>  West Ham United FC, London   ## Greater London
Fulham     =>   Fulham FC,         London   ## Greater London
Charlton | Charlton Athletic  =>  Charlton Athletic FC,  London   ## Greater London
Crystal Palace  => Crystal Palace FC,  London   ## Greater London

Wimbledon      =>  Wimbledon FC,         London   ## Greater London
AFC Wimbledon  =>  AFC Wimbledon,        London   ## London- Kingston upon Thames ??

QPR | Queens Park Rangers  =>  Queens Park Rangers FC,  London   ## Greater London
Millwall      =>  Millwall FC,             London        # London-South Bermondsey
Brentford     =>  Brentford FC,            London        # London-Brentford, Greater London
Leyton Orient  =>  Leyton Orient FC,       London  ## London-Leyton
Barnet         =>  Barnet FC,              London ## London-Edgware
Dag and Red | Dagenham and Redbridge  =>  Dagenham & Redbridge FC, London  ## London-Dagenham

Bromley          =>  Bromley FC,                London   ## London-Bromley
Hayes & Yeading  =>  Hayes & Yeading United FC,  London  ## London-Hayes
Welling United   =>  Welling United FC,          London
Sutton           =>  Sutton United FC, London

Thames           =>  Thames AFC (1928-1932),  London  ## London-Custom House





Everton    =>    Everton FC,   Liverpool › Lancashire   ## North West England
Liverpool   =>   Liverpool FC, Liverpool › Lancashire

Blackburn | Blackburn Rovers  =>   Blackburn Rovers FC,  Blackburn › Lancashire
Burnley      =>   Burnley FC,           Burnley › Lancashire
Blackpool    =>   Blackpool FC,        Blackpool › Lancashire
Preston | Preston North End  =>  Preston North End FC,    Preston › Lancashire   ## North West
Fylde        =>  AFC Fylde,            Wesham › Lancashire       ## in the Borough of Fylde
Darwen       =>  Darwen FC (1870-2009),    Darwen › Lancashire  ## North West England
Bootle       => Bootle FC (1879-1893) ,  Bootle › Lancashire
Nelson       =>  Nelson FC,           Nelson, Lancashire


Man United | Manchester United =>   Manchester United FC,  Manchester     ## North West England
Man City | Manchester City  =>   Manchester City FC,    Manchester     ## North West England

Bolton | Bolton Wanderers  =>   Bolton Wanderers FC,  Bolton › Greater Manchester
Wigan  | Wigan Athletic    =>   Wigan Athletic FC,    Wigan › Greater Manchester
Wigan Borough              =>   Wigan Borough FC (1920-1931),   Wigan › Greater Manchester    #  Lancashire
Oldham  | Oldham Athletic   =>  Oldham Athletic AFC,   Oldham › Greater Manchester
Stockport | Stockport County  =>  Stockport County FC,    Stockport › Greater Manchester
Bury         =>  Bury FC,                   Bury › Greater Manchester
Rochdale     =>  Rochdale AFC,         Rochdale › Greater Manchester
Altrincham   =>   Altrincham FC,   Altrincham › Greater Manchester
Droylsden    =>  Droylsden FC,         Droylsden › Greater Manchester
Hyde United  =>  Hyde United FC,   Hyde › Greater Manchester
Stalybridge Celtic  => Stalybridge Celtic FC, Stalybridge › Greater Manchester


Aston Villa  =>  Aston Villa FC,       Birmingham › Warwickshire   ## West Midlands
Birmingham | Birmingham City  =>  Birmingham City FC,   Birmingham › Warwickshire   ## West Midlands


Newcastle | Newcastle United  =>  Newcastle United FC,  Newcastle upon Tyne › Northumberland   ## North East
Ashington     =>  Ashington AFC, Ashington › Northumberland

South Shields  =>  South Shields FC, South Shields › Tyne and Wear
Gateshead      =>   Gateshead FC,  Gateshead › Tyne and Wear


Southampton  =>   Southampton FC,       Southampton › Hampshire
Aldershot     =>  Aldershot Town FC,     Aldershot › Hampshire
Portsmouth     =>  Portsmouth FC,        Portsmouth › Hampshire
Eastleigh      =>  Eastleigh FC,         Eastleigh › Hampshire


Sunderland   =>   Sunderland AFC,       Sunderland


Leicester | Leicester City  =>  Leicester City FC,    Leicester
Loughborough  =>  Loughborough FC (1886-1900),   Loughborough › Leicestershire,

West Brom | West Bromwich Albion   =>  West Bromwich Albion FC,  West Bromwich › West Midlands
Coventry | Coventry City   =>  Coventry City FC,       Coventry › West Midlands
Wolves | Wolverhampton Wanderers  =>  Wolverhampton Wanderers FC,   Wolverhampton › West Midlands
Walsall       =>  Walsall FC,              Walsall › West Midlands
Solihull          =>  Solihull Moors FC,   Solihull › West Midlands
Stafford Rangers  =>  Stafford Rangers FC,   Stafford › West Midlands



York | York City              =>  York City FC,         York › North Yorkshire
Middlesbrough | Middlesboro   =>  Middlesbrough FC,     Middlesbrough › North Yorkshire
Middlesbrough Ironopolis      =>  Middlesbrough Ironopolis FC (1889-1894), Middlesbrough › North Yorkshire
Scarborough                   =>  Scarborough Athletic FC,  Scarborough › North Yorkshire


Leeds | Leeds United  =>  Leeds United FC,        Leeds › West Yorkshire
Leeds City            =>  Leeds City FC (1904-1919),  Leeds › West Yorkshire

Bradford | Bradford City  =>  Bradford City AFC,         Bradford › West Yorkshire
Bradford Park Avenue      =>  Bradford Park Avenue AFC,  Bradford › West Yorkshire


Huddersfield | Huddersfield Town  =>  Huddersfield Town AFC,  Huddersfield › West Yorkshire
Halifax | Halifax Town   =>  FC Halifax Town,     Halifax › West Yorkshire
Farsley         =>  Farsley Celtic FC,     Farsley › West Yorkshire
Guiseley        =>   Guiseley AFC,   Guiseley › West Yorkshire


Hull | Hull City    =>   Hull City AFC,    Hull › East Yorkshire    ## change Hull to Kingston upon Hull  - why? why not?
North Ferriby   =>  North Ferriby United AFC,  North Ferriby › East Yorkshire

Sheffield Weds | Sheffield Wednesday  => Sheffield Wednesday FC,  Sheffield › South Yorkshire
Sheffield United => Sheffield United FC,  Sheffield › South Yorkshire

Barnsley        =>  Barnsley FC,     Barnsley › South Yorkshire
Rotherham | Rotherham United =>  Rotherham United FC,    Rotherham › South Yorkshire
Rotherham County             =>  Rotherham County FC (1870-1925), Rotherham › South Yorkshire
Rotherham Town               =>  Rotherham Town FC (1899-1925), Rotherham › South Yorkshire   ## note: a second Rotherham Town formed in 1899; first in 1878-1896
Doncaster | Doncaster Rovers =>  Doncaster Rovers FC,    Doncaster › South Yorkshire


Stoke | Stoke City   =>  Stoke City FC,          Stoke-on-Trent › Staffordshire
Port Vale      =>  Port Vale FC,           Stoke-on-Trent › Staffordshire
Burton | Burton Albion   =>  Burton Albion FC,        Burton upon Trent › Staffordshire
Burton United     => Burton United FC (1901-1910),    Burton upon Trent › Staffordshire
Burton Swifts     => Burton Swifts FC (1871-1901),    Burton upon Trent › Staffordshire
Burton Wanderers  => Burton Wanderers FC (1871-1901), Burton upon Trent › Staffordshire
Tamworth       =>   Tamworth FC,           Tamworth › Staffordshire


Derby | Derby County  =>  Derby County FC,        Derby › Derbyshire
Norwich | Norwich City =>  Norwich City FC,         Norwich › Norfolk


Watford       =>   Watford FC,       Watford › Hertfordshire

Oxford | Oxford United  =>  Oxford United FC,        Oxford › Oxfordshire


Peterboro | Peterborough United  =>  Peterborough United FC,  Peterborough › Cambridgeshire
Cambridge | Cambridge United     => Cambridge United FC,     Cambridge › Cambridgeshire
## note: there's also <=> Cambridge City  (!!)
Histon          =>  Histon FC,          Histon and Impington › Cambridgeshire


Ipswich | Ipswich Town   =>  Ipswich Town FC,   Ipswich › Suffolk

Notts County    =>  Notts County FC,           Nottingham › Nottinghamshire
Nott'm Forest | Nottingham Forest  =>  Nottingham Forest FC,   West Bridgford › Nottinghamshire
Mansfield | Mansfield Town  =>  Mansfield Town FC,      Mansfield › Nottinghamshire


Bournemouth     => AFC Bournemouth, Bournemouth › Dorset
Weymouth        =>  Weymouth FC,       Weymouth › Dorset

Reading         =>  Reading FC,             Reading › Berkshire
Maidenhead      =>  Maidenhead United FC,   Maidenhead › Berkshire

Brighton | Brighton & Hove Albion  =>  Brighton & Hove Albion FC,   Falmer › East Sussex
Crawley Town   =>   Crawley Town FC,             Crawley › West Sussex
Eastbourne Borough =>  Eastbourne Borough FC,   Eastbourne › East Sussex
Lewes                  =>  Lewes FC,          Lewes › East Sussex

Swindon | Swindon Town   =>  Swindon Town FC,  Swindon › Wiltshire

Colchester | Colchester United  =>  Colchester United FC,      Colchester › Essex
Southend | Southend United  =>  Southend United FC,     Southend-on-Sea › Essex
Braintree Town  =>  Braintree Town FC,     Braintree › Essex
Grays           =>  Grays Athletic FC,  Grays › Essex
Canvey Island   =>  Canvey Island FC,    Canvey Island › Essex


Lincoln | Lincoln City     =>  Lincoln City FC,  Lincoln › Lincolnshire
## note: there's also <=> Lincoln United  (!!)
Scunthorpe | Scunthorpe United  =>  Scunthorpe United FC,    Scunthorpe › Lincolnshire
Boston | Boston United   =>  Boston United FC,      Boston › Lincolnshire
## note: <=> there's also  Boston Town

Gainsborough Trinity  =>  Gainsborough Trinity FC, Gainsborough › Lincolnshire,


Grimsby | Grimsby Town  =>  Grimsby Town FC,        Cleethorpes › North East Lincolnshire



Bristol City   =>  Bristol City FC,       Bristol                ## South West
Bristol Rvs | Bristol Rovers  =>  Bristol Rovers FC,     Bristol


Tranmere | Tranmere Rovers  =>  Tranmere Rovers FC,    Birkenhead › Merseyside
Southport           =>   Southport FC,   Southport › Merseyside
New Brighton | New Brighton Tower  => New Brighton Tower FC (1898-1901), New Brighton › Merseyside


Plymouth | Plymouth Argyle  =>  Plymouth Argyle FC,     Plymouth › Devon
Exeter | Exeter City        =>  Exeter City FC,         Exeter › Devon
Torquay | Torquay United    =>  Torquay United FC,      Torquay › Devon


Gillingham    =>  Gillingham FC,          Gillingham › Kent
Maidstone | Maidstone United  =>  Maidstone United FC,    Maidstone › Kent
Dartford        =>  Dartford FC,     Dartford › Kent
Dover Athletic  =>  Dover Athletic FC,  Dover › Kent
Ebbsfleet | Gravesend  =>    Ebbsfleet United FC,  Northfleet › Kent   ## note: before 2007, the club was called Gravesend & Northfleet



Luton | Luton Town    =>  Luton Town FC,          Luton › Bedfordshire


Milton Keynes Dons => Milton Keynes Dons FC,   Milton Keynes › Buckinghamshire
Wycombe | Wycombe Wanderers  =>  Wycombe Wanderers FC,  High Wycombe › Buckinghamshire


Yeovil        =>  Yeovil Town FC,              Yeovil › Somerset
Bath City              =>  Bath City FC,       Bath › Somerset


Forest Green   =>  Forest Green Rovers FC,     Nailsworth › Gloucestershire
Cheltenham     =>  Cheltenham Town FC,         Cheltenham › Gloucestershire
## note: there's also <=> Cheltenham Saracens  (!!)

Kidderminster | Kidderminster Harriers  => Kidderminster Harriers FC,  Kidderminster › Worcestershire
Woking         => Woking FC,                  Woking › Surrey


Chesterfield   =>  Chesterfield FC,       Chesterfield › Derbyshire
Alfreton Town   =>  Alfreton Town FC,   Alfreton › Derbyshire
Glossop North End  =>  Glossop North End AFC, Glossop › Derbyshire


Carlisle | Carlisle United =>  Carlisle United FC,    Carlisle › Cumbria
## note: there's also <=> Carlisle City FC (!!)
Barrow       =>   Barrow AFC,    Barrow-in-Furness › Cumbria
## note: <=> there's also  Barrow Town
Workington   =>   Workington AFC, Workington › Cumbria


Northampton | Northampton Town => Northampton Town FC,    Northampton › Northamptonshire
## note: there's also <=> Northampton Sileby Rangers  (!!)
Rushden & D | Rushden & Diamonds =>  AFC Rushden & Diamonds,   Rushden › Northamptonshire
Kettering Town  =>  Kettering Town FC,  Kettering › Northamptonshire


Shrewsbury | Shrewsbury Town =>  Shrewsbury Town FC,   Shrewsbury › Shropshire
Telford United         =>  Telford United FC (1872-2004),   Telford › Shropshire
AFC Telford United     =>  AFC Telford United (2004-),  Telford › Shropshire


Chester       =>  Chester FC,    Chester › Cheshire
Crewe | Crewe Alexandra     =>  Crewe Alexandra FC,    Crewe › Cheshire
Macclesfield   =>  Macclesfield Town FC, Macclesfield › Cheshire
Northwich | Northwich Victoria   =>  Northwich Victoria FC,  Northwich › Cheshire


Fleetwood Town  =>  Fleetwood Town FC,  Fleetwood › Lancashire
Accrington | Accrington Stanley  =>  Accrington Stanley FC,  Accrington › Lancashire
Accrington F.C.                  =>  Accrington FC (1878-1896),  Accrington › Lancashire
Morecambe     =>  Morecambe FC,           Morecambe › Lancashire


Hereford        => Hereford FC (2014-),            Hereford › Herefordshire
Hereford United => Hereford United FC (1924-2014), Hereford › Herefordshire

St. Albans    =>  St. Albans City FC,  St. Albans  › Hertfordshire
Boreham Wood  =>  Boreham Wood FC,     Borehamwood › Hertfordshire
Stevenage | Stevenage Borough  =>  Stevenage FC,        Stevenage   › Hertfordshire


Hartlepool | Hartlepool United   => Hartlepool United FC,   Hartlepool › Durham
Darlington    =>    Darlington FC, Darlington › Durham
## note: <=> there's also  Darlington Railway Athletic

Durham City  => Durham City AFC, Durham › Durham


Salisbury       =>  Salisbury City FC (1947-2014),  Salisbury › Wiltshire
Nuneaton Town   =>  Nuneaton Borough FC,    Nuneaton › Warwickshire





####
#  note: english teams in scotish league !!!

Berwick            =>  Berwick Rangers,  Berwick-upon-Tweed       ## note: in England !!!
