############################
## es-espana (spain) - [es]


Ath Madrid | Atletico Madrid   => Atlético Madrid,    Madrid › Comunidad de Madrid   ## use Atlético de Madrid - why? why not?
Ath Madrid B  => Atlético Madrid B,  Madrid › Comunidad de Madrid

Real Madrid   => Real Madrid CF,   Madrid › Comunidad de Madrid
Real Madrid B => Real Madrid CF B, Madrid › Comunidad de Madrid

Getafe        => Getafe CF,      Madrid › Comunidad de Madrid
Vallecano     => Rayo Vallecano, Madrid › Comunidad de Madrid

Alcorcon  => AD Alcorcón, Alcorcón › Comunidad de Madrid   ## use Madrid (Alcorcón) - why? why not?




Malaga         => Málaga CF,   Málaga › Andalucía
Malaga B       => Málaga CF B, Málaga › Andalucía

Sevilla       => Sevilla FC,   Sevilla › Andalucía
Sevilla B     => Sevilla FC B, Sevilla › Andalucía

Betis       => Real Betis, Sevilla › Andalucía

Algeciras  => Algeciras CF,     Algeciras › Andalucía
Almeria    => UD Almería,       Almería   › Andalucía
Cadiz      => Cádiz CF,         Cádiz     › Andalucía
Cordoba    => Córdoba CF,       Córdoba   › Andalucía
Ecija      => Écija Balompié,   Écija     › Andalucía
Jaen       => Real Jaén CF,     Jaén      › Andalucía

## note: different from Granada 74 <=> Granda (CF) !!!
##   see https://es.wikipedia.org/wiki/Granada_74_Club_de_Fútbol
Granada        => Granada CF, Granada › Andalucía
Granada 74     => Granada 74, Granada › Andalucía





Barcelona    => FC Barcelona,   Barcelona › Cataluña
Barcelona B  => FC Barcelona B, Barcelona › Cataluña

Espanol      => RCD Español, Barcelona › Cataluña

Gimnastic  => Gimnàstic Tarragona, Tarragona › Cataluña
Girona     => Girona FC,           Gerona    › Cataluña


La Coruna    => RCD La Coruña,  La Coruña  › Galicia
Celta        => RC Celta Vigo,  Vigo       › Galicia        ## use R. C. Celta de Vigo - why? why not?
Compostela   => SD Compostela,  Santiago de Compostela › Galicia
Ferrol       => Racing Ferrol,  Ferrol     › Galicia


Valencia    => Valencia CF,    Valencia › Comunidad Valenciana
Levante     => Levante UD,     Valencia › Comunidad Valenciana

Alicante    => Alicante CF,    Alicante › Comunidad Valenciana
Hercules    => Hércules CF,    Alicante › Comunidad Valenciana

Alcoyano    => CD Alcoyano,    Alcoy    › Comunidad Valenciana
Elche       => Elche CF,       Elche    › Comunidad Valenciana
Castellon   => CD Castellón,   Castellón de la Plana › Comunidad Valenciana

Villarreal | Villareal   => Villarreal CF,    Villarreal › Comunidad Valenciana    ## fix typo Villareal
Villarreal B             => Villarreal CF B,  Villarreal › Comunidad Valenciana



Sociedad     => Real Sociedad,     San Sebastián › País Vasco
Alaves       => Deportivo Alavés,  Vitoria       › País Vasco
Eibar        => SD Eibar,          Eibar         › País Vasco


Ath Bilbao   => Athletic Club Bilbao,   Bilbao › País Vasco    ## use Athletic Club - why? why not?
Ath Bilbao B => Athletic Club Bilbao B, Bilbao › País Vasco

Sp Gijon    => Sporting Gijón, Gijón › Asturias    ## use Sporting de Gijón - why? why not?



Albacete     => Albacete Balompié,  Albacete    › Castilla-La Mancha
Guadalajara  => CD Guadalajara,     Guadalajara › Castilla-La Mancha


Badajoz      => CD Badajoz,      Badajoz      › Extremadura
Extremadura  => CF Extremadura,  Almendralejo › Extremadura
Merida       => CP Mérida,       Mérida       › Extremadura


Burgos     => Burgos CF,   Burgos          › Castilla y León
Mirandes   => CD Mirandés, Miranda de Ebro › Castilla y León


Murcia           => Real Murcia CF,      Murcia › Región de Murcia
UCAM Murcia      => UCAM Murcia,         Murcia › Región de Murcia
Ciudad de Murcia => CF Ciudad de Murcia, Murcia › Región de Murcia

Cartagena        => FC Cartagena,  Cartagena › Región de Murcia


Huesca       => SD Huesca, Huesca › Aragón


Las Palmas     => UD Las Palmas,          Las Palmas › Islas Canarias
U.Las Palmas   => Universidad Las Palmas, Las Palmas › Islas Canarias

Mallorca        => RCD Mallorca,   Palma de Mallorca › Islas Baleares
Mallorca B      => RCD Mallorca B, Palma de Mallorca › Islas Baleares



Leganes          => CD Leganés,
Leonesa          => Cultural Leonesa,
Lerida | Lleida  => UE Lleida,
Llagostera       => UE Llagostera,
Logrones         => CD Logroñés,
Lorca            => Lorca FC,
Lugo             => CD Lugo,


Numancia          => CD Numancia,
Osasuna           => CA Osasuna,
Ourense | Orense  => CD Ourense,
Oviedo            => Real Oviedo,
Poli Ejido    => Polideportivo Ejido,
Ponferradina  => SD Ponferradina,
Pontevedra    => Pontevedra CF,

Real Union     => Real Unión,
Recreativo     => Recreativo Huelva,
Reus Deportiu  => CF Reus,
Sabadell       => CE Sabadell,
Salamanca      => UD Salamanca,
Santander      => Real Racing Santander,

Tenerife       => CD Tenerife,
Terrassa       => Terrassa FC,
Toledo         => CD Toledo,

Valladolid     => Real Valladolid CF,
Vecindario     => UD Vecindario,

Xerez          => Xerez CD,
Zaragoza       => Real Zaragoza,
