#############################################
## fr-france
##
##  note: see mc.txt for monaco


Paris SG    => Paris Saint-Germain, Paris › Île-de-France
Paris FC    => Paris FC,            Paris › Île-de-France

##
# Red Star History
# - Red Star FC 93 (2003-2012)
# - Red Star FC (2012-)
Red Star | Red Star 93   => Red Star FC,   Saint-Ouen › Île-de-France



Amiens      => Amiens SC,             Amiens   › Hauts-de-France
Angers      => Angers SCO,            Angers   › Pays de la Loire
Bordeaux    => Girondins de Bordeaux, Bordeaux › Nouvelle-Aquitaine


Caen        => Stade Malherbe Caen, Caen    ## use - SM Caean - why? why not?
Dijon       => Dijon FCO, Dijon
Guingamp    => EA Guingamp, Guingamp
Lille       => Lille OSC, Lille
Lyon | Olympique Lyon  => Olympique Lyonnais, Lyon
Marseille | Olympique Marseille  => Olympique de Marseille, Marseille
Metz        => FC Metz, Metz

Montpellier => Montpellier HSC, Montpellier   ## use - Montpellier Hérault SC - why? why not?
Nantes      => FC Nantes, Nantes
Nice        => OGC Nice, Nice


Rennes      => Stade Rennais FC, Rennes
St Etienne | AS Saint-Etienne  => AS Saint-Étienne, Saint-Étienne
Strasbourg  => RC Strasbourg, Strasbourg
Toulouse    => Toulouse FC, Toulouse
Troyes      => ES Troyes AC, Troyes
Reims       => Stade de Reims, Reims
Nimes       => Nîmes Olympique, Nîmes

Ajaccio         => AC Ajaccio,  Ajaccio
Ajaccio GFCO    => GFC Ajaccio, Ajaccio

Auxerre         => AJ Auxerre, Auxerre
Bourg Peronnas  => Bourg-en-Bresse 01, Bourg-en-Bresse     ## use - Football Bourg-en-Bresse Péronnas 01 - why? why not?
Brest           => Stade Brestois 29, Brest
Chateauroux     => LB Châteauroux, Châteauroux
Clermont        => Clermont Foot 63, Clermont
Le Havre        => Le Havre AC, Le Havre
Lens            => RC Lens, Lens
Lorient         => FC Lorient, Lorient
Nancy           => AS Nancy Lorraine, Nancy
Niort           => Chamois Niortais FC, Niort
Orleans         => US Orléans, Orléans

Quevilly Rouen  => US Quevilly-Rouen Métropole,  Petit-Quevilly   ## use Quevilly-Rouen - why? why not?
Sochaux         => FC Sochaux-Montbéliard, Montbéliard
Tours           => Tours FC, Tours
Valenciennes    => Valenciennes FC, Valenciennes

Arles            => AC Arles-Avignon, Avignon

Bastia           => SC Bastia, Bastia
CA Bastia        => CA Bastia, Bastia

Beauvais         => AS Beauvais Oise,  Beauvais Oise

Besancon         => Racing Besançon, Besançon   ## use Besançon RC - why? why not?
Boulogne         => US Boulogne,  Boulogne-sur-Mer
Cannes           => AS Cannes, Cannes
Charleville      => FCO Charleville, Charleville-Mézières
Creteil          => US Créteil, Créteil
Epinal           => SAS Épinal,  Épinal
Evian Thonon Gaillard  => Évian TG FC, Thonon-les-Bains     ## use Évian Thonon-Gaillard FC - why? why not?
Grenoble         => Grenoble Foot 38, Grenoble
Gueugnon       => FC Gueugnon, Gueugnon
Istres         => FC Istres, Istres
Laval          => Stade Lavallois, Laval
Le Mans        => Le Mans FC, Le Mans
Libourne       => FC Libourne-Saint-Seurin, Libourne
Louhans-Cuis.  => CS Louhans-Cuiseaux,   Louhans  ## and Cuiseaux
Martigues      => FC Martigues, Martigues
Mulhouse       => FC Mulhouse, Mulhouse
Perpignan      => Perpignan FC,  Canet-en-Roussillon


Rouen          => FC Rouen,  Rouen
Sedan          => CS Sedan-Ardennes,  Sedan
Sete           => FC Sète,  Sète
St Brieuc      => Stade Briochin, Saint-Brieuc
Toulon         => Sporting Toulon Var, Toulon

Valence        => ASOA Valence, Valence   ## use Olympique Valence - why? why not?
Vannes         => Vannes OC,   Vannes
Wasquehal      => Wasquehal Foot, Wasquehal     ## use ES Wasquehal - why? why not?
