####################################################
# gr-greece


AEK | AEK Athens   =>  AEK Athens FC,     Athens    ## use!? - Marousi or Maroussi a suburban city in the northeastern part of the Athens agglomeration
Panathinaikos  =>  Panathinaikos FC,  Athens
Apollon        =>  Apollon Smyrnis FC,  Athens
Atromitos      =>  Atromitos FC,      Athens    ## use!? - Peristeri a suburban municipality in the northwestern part of the Athens agglomeration
Panionios      =>  Panionios GSS,     Athens    ## use!? - Nea Smyrni a municipality and a southern suburb of Athens
Akratitos      =>  APO Akratitos,      Athens        ## Ano Liosia, Athens
Athinaikos     =>  Athinaikos AS FC,   Athens

Chalkidona     => Chalkidona FC, Athens   ## Nikaia - a suburb in the western part of the Athens agglomeration
Egaleo         => Egaleo FC, Athens   ## Egaleo - a suburb of Athens

Ethnikos Asteras | Eth Asteras => Ethnikos Asteras FC, Athens   ## Kaisariani - a suburban town and a municipality in the eastern part of the Athens agglomeration

Kalithea | Kallithea  =>  Kallithea FC, Kallithea   ## Kallithea - the 4th biggest in the Athens urban area
Thrasyvoulos         => Thrasyvoulos FC,  Fyli  ##  a town and a municipality in the northwestern part of Attica; a suburb of Athens

Eleysina        =>  Panelefsiniakos FC, Elefsina › Attica


Proodeftiki | Proodeytiki => Proodeftiki FC, Nikaia › Attica
Ionikos      => Ionikos FC, Nikaia › Attica   ## Athens Nikaia - a suburb in the western part of the Athens agglomeration


Olympiakos | Olympiacos        => Olympiacos Piraeus FC,  Piraeus › Attica
Ethnikos Piraeus | Ethnikos    => Ethnikos Piraeus FC,    Piraeus › Attica



PAOK              =>  PAOK FC,              Thessaloniki › Central Macedonia
Aris              =>  Aris Thessaloniki FC, Thessaloniki › Central Macedonia
Iraklis           => Iraklis 1908 Thessaloniki FC, Thessaloniki › Central Macedonia

Kalamaria  =>  Apollon Pontou FC, Kalamaria › Central Macedonia    ## Kalamaria, Thessaloniki


Asteras Tripolis  =>  Asteras Tripolis FC, Tripoli › Peloponnese

Xanthi        =>  Xanthi FC,           Xanthi › Thrace
Panetolikos   =>  Panetolikos GFS,     Agrinio › West Greece
Giannina | Yiannina  =>  PAS Giannina FC,     Ioannina › Epirus
Levadeiakos         =>  Levadiakos FC,       Livadeia › Central Greece
Larisa        =>  AE Larissa FC,       Larissa › Thessaly
Lamia         =>  PAS Lamia 1964,      Lamia › Central Greece
Kerkyra       =>  Kerkyra FC,          Corfu › Ionian Islands
Platanias     =>  Platanias FC,        Chania › Crete



Doxa | Doxa Dramas   => Doxa Dramas FC, Drama › Macedonia

Edessaikos           => Edessaikos FC,  Edessa › Macedonia





Ergotelis       => Ergotelis FC, Heraklion › Crete
OFI             => OFI Crete FC, Heraklion › Crete


Kalamata   =>  Kalamata FC,       Kalamata › Peloponnese

Kallonis   =>  AEL Kalloni FC, Kalloni › Aegean Islands
Kastoria   =>  Kastoria FC, Kastoria › Macedonia
Kavala     =>  Kavala FC, Kavala › Macedonia

Niki Volos        => Niki Volou FC, Volos › Thessaly
Olympiakos Volou  => Olympiacos Volou 1937 FC, Volos › Thessaly

Levadiakos  => Levadiakos FC, Livadeia › Central Greece


Panahaiki   => Panachaiki FC, Patras › Peloponnese


Paniliakos   => Paniliakos FC, Pyrgos › Peloponnese
Panserraikos => Panserraikos FC, Serres › Macedonia
Panthrakikos => Panthrakikos FC, Komotini › Thrace


Trikala      => Trikala FC, Trikala › Thessaly

Veria | Veroia  =>   Veria FC, Veria › Macedonia
